30 30
1730 160
1 1 1 1 1 1 1 1 1 1 1 1 1 1 1 1 1 1 1 1 1 1 1 1 1 1 1 1 1 1 
1 4 4 4 4 4 4 4 4 4 4 4 4 4 4 4 4 1 4 4 4 4 4 4 4 1 1 1 1 1
1 4 4 4 4 4 4 4 4 4 4 4 4 4 4 4 4 1 4 4 4 4 4 4 4 4 4 4 4 1
1 4 4 4 4 4 4 4 4 4 1 1 1 1 1 4 4 1 4 4 4 4 1 4 4 4 1 4 4 1
1 4 4 4 4 4 4 4 4 4 4 1 4 4 1 4 4 1 1 4 4 4 1 4 4 4 1 4 4 1
1 4 4 4 4 4 4 1 4 4 4 1 4 4 4 4 4 1 1 4 4 4 1 4 4 4 1 4 4 1
1 1 1 1 1 4 4 1 4 4 4 1 4 4 4 4 4 4 4 4 4 4 1 4 4 4 4 4 4 1
1 1 1 1 1 4 4 1 4 4 4 1 4 4 1 4 4 4 4 4 4 4 4 4 4 4 4 4 4 1
1 4 4 4 1 4 4 1 1 4 4 1 4 4 1 4 4 4 4 4 4 4 4 4 1 1 1 1 1 1
1 4 4 4 4 4 4 4 4 4 4 1 4 4 1 1 1 1 1 1 4 4 4 4 1 4 4 4 4 1
1 4 4 4 4 4 4 4 4 4 4 1 4 4 4 4 4 4 4 4 4 4 4 4 1 4 4 4 4 1
1 4 4 4 4 4 4 4 4 4 4 1 4 4 4 4 4 4 4 4 4 4 4 4 1 4 4 4 4 1
1 4 4 4 4 4 4 1 4 4 4 1 4 4 4 1 4 4 4 1 4 4 4 4 1 4 4 4 4 1
1 1 1 1 1 1 1 1 4 4 4 1 4 4 4 1 4 4 4 1 4 4 4 4 1 4 4 4 4 1
1 4 4 4 4 1 1 1 4 4 4 1 1 1 1 1 4 4 4 1 4 4 4 4 4 4 4 4 4 1
1 4 4 4 4 4 1 1 4 4 4 4 4 4 4 1 4 4 4 1 4 4 4 4 4 4 4 4 4 1
1 4 4 4 4 4 4 1 4 4 4 4 4 4 4 1 4 4 1 1 1 4 4 4 4 4 4 4 4 1
1 4 4 4 4 1 1 1 4 4 1 1 1 1 1 1 4 4 1 2 1 4 4 4 1 4 4 4 4 1
1 4 4 4 4 4 4 1 4 4 1 4 4 4 4 4 4 4 1 4 1 4 4 4 1 4 4 4 4 1
1 4 4 4 4 4 4 1 4 4 1 4 4 4 4 4 4 4 4 4 4 4 4 4 1 4 4 4 4 1
1 4 4 4 4 4 4 1 4 4 1 4 4 4 4 4 4 4 4 4 4 4 4 4 1 4 4 4 4 1
1 4 4 4 4 4 4 4 4 4 1 1 1 4 4 4 4 4 4 4 4 4 4 4 1 4 4 4 4 1
1 4 4 4 4 4 4 4 4 4 4 4 4 4 1 4 4 4 4 4 4 4 4 4 1 4 4 4 4 1
1 4 4 4 4 4 4 1 4 4 4 4 4 4 1 4 4 4 4 4 4 4 4 4 1 4 4 4 4 1
1 4 4 4 4 4 4 1 4 4 4 4 4 4 1 4 4 4 4 4 4 4 4 4 1 4 4 4 4 1
1 4 4 4 4 4 4 1 4 4 4 4 4 4 1 4 4 4 4 4 4 4 4 4 1 4 4 4 4 1
1 4 4 4 4 4 4 1 4 4 4 4 4 4 4 4 4 4 4 4 4 4 4 4 4 4 4 4 4 1
1 4 4 4 4 4 4 1 4 4 4 4 4 4 4 4 4 4 4 4 4 4 4 4 4 4 4 4 4 1
1 4 4 4 4 4 4 1 4 4 4 4 4 4 1 4 4 4 4 4 4 4 4 4 1 4 4 4 4 1
1 1 1 1 1 1 1 1 1 1 1 1 1 1 1 1 1 1 1 1 1 1 1 1 1 1 1 1 1 1







